Bir "G" grubu, ilgili alanlarýn bir kombinasyonudur. Bir "R" grubu, ilgili alanlarýn tekrarlanabilir bir kombinasyonudur. Daha sonraki paragraflarda tanýmlandýðý þekilde varlýk ve yineleme göstergelerine gruplar halinde izin verilecektir.


ALAN ÖNCELÝK GÖSTERGELERÝ (FPI'ler)
FPI'ler, aþaðýdaki alanýn varlýðýný (FPI = 1) veya yokluðunu (FPI = 0) göstermek için kullanýlýr ve zorunlu veya tek bit alanlar için kullanýlmaz. FPI'ler, alan bir grup içinde deðilse ve grup mevcutsa alanýn iletilmesi gerekmedikçe isteðe baðlý ve isteðe baðlý alanlardan önce gelmelidir.


SAHA GEREÐÝ GÖSTERGELERÝ (FRI'ler)
Alanlar 1 bit FRI ile tekrarlanabilir olarak tanýmlanabilir. Bir alanýn bir FPI'den önce gelmesi durumunda, FPI = 1, FRI'nin ilk oluþumundan önce gelecektir ve sonraki tekrarlar için mevcut deðildir. FPI = 0 ise, ne FRI ne de alan mesajda bulunur. Bir FRI = 1, bu yinelemeden sonra alanýn tekrarlandýðýný gösterir. Bir FRI = 0, alanýn bu yinelemeden sonra gerçekleþmeyeceðini belirtir. Tekrarlanan bir alan için ilk görünüm de dahil olmak üzere maksimum görünüm sayýsý, mesaj açýklamasýnda Tekrar Kodu sütununda parantez içinde belirtilmiþtir


GRUP PRESENCE(varlýk) GÖSTERGELERÝ (GPI)

GPI, mantýksal olarak gruplandýrýlmýþ bir alan kümesinin varlýðýný (GPI = 1) veya yokluðunu (GPI = 0) belirtmek için kullanýlýr. Grubun her alaný, paragraf 5.5.6.2'de açýklandýðý gibi Grup Kodu sütununda iþaretlenmelidir. FPI'lere, FRI'lere, GPI'lara ve GRI'lara gruplar halinde izin verilecektir. Bir GPI'ye, bir mesaj açýklamasýnýn Çözünürlük, Kodlama, Etc sütununda anlamsal olarak anlamlý bir grup adý atanmalýdýr. Bir "G" grubuna atanan hiçbir grup ismi bir mesaj tanýmýnda tekrarlanmayacaktýr.


GRUP KAYNAK GÖSTERGELERÝ (GRI'ler)

Bir GRI, bir alan grubunun tekrarlanabilir olduðunu belirtmek için kullanýlýr. Bu alan grubuna “R” grubu denilebilir. Tekrar grubunun her alaný, paragraf 5.5.6.3'te açýklandýðý gibi Tekrar Kodu sütununda iþaretlenmelidir. Bir GRI = 1, bu yinelemeden sonra grubun tekrarlandýðýný gösterir. Bir GRI = 0, grubun bu yinelemeden sonra oluþmayacaðýný belirtir. Tekrarlanan bir grup için ilk görünüm de dahil olmak üzere maksimum görünüm sayýsý, mesaj açýklamasýnda Tekrar Kodu sütununda parantez içinde belirtilmiþtir. Bir "R" grubunun bir GPI'den önce gelmesi durumunda, GPI = 1, GRI'nýn ilk oluþumundan önce gelecektir ve sonraki tekrarlar için mevcut deðildir. GPI = 0 ise, ne GRI ne de grup mesajda bulunur.


“M”, Bölüm 3'te tanýmlandýðý þekilde zorunlu bir alaný gösterir.
“X”, Bölüm 3'te tanýmlandýðý gibi isteðe baðlý bir alaný belirtir.
“#”, Bölüm 3'te tanýmlandýðý gibi isteðe baðlý bir alaný belirtir.


Gruplar, GN'nin numaralandýrýlmýþ gruplandýrmaya iþaret ettiðini belirtir (not: G1, mesaj içindeki ilk "G" grubunu gösterir; G2, mesajdaki ikinci "G" grubunu gösterir; vb.)
G1 / G2, G2’nin G1’de yuvalanmýþ olduðunu gösterir.







R - Bu alanýn veya grubun tekrarlanabilir olduðunu gösterir.
    • RN - Bu alanýn veya grubun, tekrarlanabilir dizi numarasýný belirterek N ile tekrarlanabileceðini belirtir (yani, R1, mesaj içindeki ilk tekrarlanabilir alaný veya grubu gösterir; R2, mesajdaki ikinci tekrarlanabilir alaný veya grubu gösterir; vb.).
    • RN (NA) - Bir mesajda alanýn veya grubun maksimum görünüþ sayýsýný belirten, A ile tekrarlanabilir bir alanýn veya grubun ilk alaný ile görünür (yani R3 (3)).
    • R1 / R2, R2’nin R1 içinde yuvalanmýþ olduðunu gösterir.





















AAR - Havadan Havaya Yakýt Ikmali
ABCCC - Havadan Savaþ Muharebe Komuta Kontrol Merkezi
ACA - Hava Sahasý Koordinasyon Alaný
ACAP - Geliþmiþ Yetenek
ACC - Hava Muharebe Komutanlýðý
ACFTB - Uçak Bilgi Uzantýsý
ACK - Teþekkür, Teþekkür
ACM - Hava Sahasý Kontrolü
ACP - Müttefik Ýletiþim Yayýný
ADC - Otomatik Veri Dönüþtürücü
ADZ - Hava Savunma Bölgesi
ADMIN - Ýdari
AFATDS - Ýleri Saha Topçu Taktik Veri Sistemi
AFSC - Hava Kuvvetleri Ýhtisas Kodu
AGL - Yer Seviyesi Üstü
AGM - Havadan Yere Füze
AIM - Hava Durdurma Füzesi
AIMIDB - Uçak Ek Görüntü Tanýmlamasý
AIR ACT - Hava Platformu Etkinliði
AIS - Bilgi Standartlarý Birliði
AMRAAM - Geliþmiþ Orta Menzilli Havadan Havaya Füze
ANSI - Amerikan Ulusal Standartlar Enstitüsü
AOU - Belirsizlik Alaný
AP - Anti-Personel
APF - Uçak Paraþütü Parlamasý
APKWS - Geliþmiþ Hassas Öldürme Silahý Sistemi
AP / AM - Anti-Personel / Anti-Malzeme
APPS - Analitik Fotogrametrik Konum / Ýþleme Sistemi
ARM - Anti-Radyasyon Füzesi
ASAS - Tüm Kaynak Analiz Sistemi
ASCA - Hava Destek Kontrol Ajansý
ASCII - Bilgi Deðiþimi Ýçin Amerikan Standart Kodu
ASOC - Hava Destek Operasyon Merkezi


ASR - Mühimmat Ýkmal Oraný
ASRAAM - Geliþmiþ Kýsa Menzilli Havadan Havaya Füze
AT - Tank Karþýtý
ATACMS - Ordu Taktik Füze Sistemi
AT / AP - Tank / Anti-Personel
ATC - Hava Trafik Kontrolü
ATI - Topçu Hedef Ýstihbaratý
ATR - Otomatik Hedef Tanýma
ATS - Hava Trafik Hizmetleri
OTOMATÝK - Otomatik
AWACS - Havadan Uyarý ve Kontrol Sistemi
AXS ORI - Eksen Yönü
BB - Baz Bantlama
BCS - Batarya Bilgisayar Sistemi
BDU - Bomba Kukla Ünitesi
BGM - Balistik Güdümlü Füze
BRIL - Temel Gereksinimler Öðe Listesi
BTM - Patlama Testi Füzesi
C2 - Komuta ve Kontrol
C2E - Komuta ve Kontrol Elemaný
C3I - Komuta, Kontrol, Ýletiþim ve Ýstihbarat
C4I - Komut, Kontrol, Ýletiþim, Bilgisayarlar ve
  Zeka
C4RDP - Komuta, Kontrol, Ýletiþim ve Bilgisayar Gereksinimleri
  Veritabaný Programý
CAEE - Sýkýþtýrma Algoritmasý EagleEye
CANTPRO - Ýþlem yapýlamýyor
CAS - Yakýn Hava Desteði
CASBDA - Yakýn Hava Desteði Görev Savaþ Hasar Deðerlendirmesi
CBU - Küme Bomba Birimi
CCB - Yapýlandýrma Kontrol Kartý
CCD - Þarj Baðlantýlý Cihaz
CDR - Kimyasal Düþme Raporu
CE - Kontrollü Uzatma
CEM - Kombine Etkiler Mühimmatý
CFF - Ateþ Çaðrýsý
CGM - Bilgisayar Grafikleri Meta Dosyasý
CHA - Kimyasal Tehlike Alaný
CI - Yapýlandýrma Öðesi
CJCSI - Genelkurmay Baþkanlýðý Öðretim Baþkaný
CJCSM - Genelkurmay Baþkanlarý El Kitabý Baþkaný
CM - Yapýlandýrma Yönetimi
CMOS - Tamamlayýcý Metal Oksit Yarý Ýletken
COM - Kütle Merkezi
ÝLETÝÞÝM - Ýletiþim


COMRAT - Sýkýþtýrma Oraný
ÝSEDAK - Ýletiþim Güvenliði
CRD - Capstone Gereksinimleri Belgesi
C / S / A - Savaþ Komutaný / Hizmet / Ajans
CSMA - Taþýyýcý Anlamda Çoklu Eriþim
CSS - Merkezi Güvenlik Hizmeti
CSS - Savaþ Hizmeti Desteði
CTIL - Komutanlar Ýzlenen Öðe Listesi
CUCV - Ticari Tesis Kargo Aracý
CW - Sürekli Dalga
DA - Hasar Deðerlendirmesi
DASC - Doðrudan Hava Destek Merkezi
DED - Veri Öðesi Sözlüðü
DES - Veri Uzantýsý Segmenti
DFI - Veri Alaný Tanýmlayýcýsý
DGIWG - Dijital Coðrafi Bilgi Çalýþma Grubu
DI - Veri Öðesi
DID - Cihaz Tanýmlayýcýsý
DIDS - Cihaz Tanýmlayýcýlarý
DIGEST - Dijital Coðrafi Bilgi Deðiþimi Standardý
DISA - Savunma Bilgi Sistemleri Ajansý
DMTD - Dijital Mesaj Aktarým Cihazý
DoD - Savunma Bakanlýðý
DOP - Koruma Derecesi
DPICM - Ýki Amaçlý Geliþtirilmiþ Konvansiyonel Mühimmat
DPPDB - Dijital Nokta Konum Veri Tabaný
DSU - Veri Depolama Birimi
DTEM - Dijital Arazi Yükseltme Modeli
DTG - Tarih-Zaman Grubu
DUI - Veri Kullanýmý Tanýmlayýcýsý
EA - Elektronik Saldýrý
EF - Eleman Filtreli
EIRN - Varlýk Kimliði Referans Numarasý
EISN - Varlýk Kimliði Seri Numarasý
ELINT - Elektronik Ýstihbarat
EM - Elektromanyetik
Merck - Mühendislik Ýmalat Geliþtirme
EMG IND - Acil Durum Göstergesi
EO - Elektro-optik
EOB - Savaþýn Elektronik Düzeni
EOM - Görev Sonu
EP - Elektronik Koruma
EPLRS - Geliþmiþ Konum Konum Raporlama Sistemi
EPW'ler - Düþman Savaþ Mahkumlarý

ES - Elektronik Harp Desteði
ESM - Elektronik Harp Destek Önlemleri
ETE - Uçtan Uca
EX IND - Egzersiz Göstergesi
EW - Elektronik Harp
F / R IND - Frekans Aralýðý Göstergesi
FAB - Yakýt Hava Bombasý
FAC - Ýleri Hava Kontrol Cihazý
FAD - Ýþlevsel Alan Göstergesi
FAPES - Güçlendirme Planlama ve Uygulama Sistemini Zorla
FASCAM - Daðýnýk Maden Ailesi
FATDS - Tarla Topçu Taktik Veri Sistemleri
FBCB2 - Zorla XXI Muharebe Komutanlýðý Tugayý ve Altýnda
FCE - Yangýn Kontrol Elemaný
FCR - Yangýn Kontrol Radarý
FDD - Ýlk Sayýsallaþtýrýlmýþ Bölüm
FDS - Yangýn Yönlendirme Sistemi
FFA - Ücretsiz Yangýn Alaný
FFAR - Katlanýr Fin Uçak Roketi
FFCC - Kuvvet Yangýnlarý Koordinasyon Merkezi
FHDR - Dosya Baþlýðý
FIFO - Ýlk Giren / Ýlk Giren
FLIR - Ýleriye Bakýþ Kýzýlötesi
FLOT - Kendi Birliklerinin Ýleri Hattý
FMF - Sabit Mesaj Formatlarý
FMU - Fuze Mühimmat Ünitesi
FO - Ýleri Gözlemci
FOS - Ýleri Gözlemci Sistemi
FPF - Son Koruyucu Ateþ
FPI - Saha Durum Göstergesi
FRI - Alan Nüks Göstergesi
FRAGO - Parça Sipariþi
FRQ1 - Frekans, 1
FRQ2 - Frekans, 2
FRQ ML - Frekans Çarpaný
FSCA - Yangýn Destek Koordinasyon Acenteleri
FSCC - Yangýn Destek Koordinasyon Merkezi
FSE - Ateþ Destek Elemaný
FU / PLV - Ýtfaiye / Takým Lideri Aracý
FVER - Dosya Sürümü
FVU - Yönlendirme VMF Ünitesi
FVUJ - VMF Ünitesi J'nin iletilmesi (VMF ile Link 16 arasýnda)
FZU - Birleþtirme Ünitesi
G / VLLD - Zemin / Araç Lazer Konumlandýrýcý Göstergesi

GAMO - Kara ve Amfibi Askeri Operasyonlar
GAT - Genel Hava Trafiði
GBU - Güdümlü Bomba Ünitesi
GCC - Toprak Bileþeni Komutaný
GCCS - Global Komuta Kontrol Sistemi
GEOPS - Coðrafi Konum Bilgisi
GP - Genel Amaç
GPI - Grup Durum Göstergesi
GPS - Global Konumlandýrma Sistemi
GRI - Grup Nüks Göstergesi
GYRO - Jiroskop
HARM - Yüksek Hýzlý Radyasyon Füzesi
HAVCO - Uydunuz
HE - Yüksek Patlayýcý
ISI - Yüksek Patlayýcý Karþýtý Tank
HIMARS - Yüksek Hareketli Topçu Roket Sistemi
HMMWV - Yüksek Hareketli Çok Amaçlý Tekerlekli Araç
IADB - Amerikalar Arasý Savunma Kurulu
IC - Resim Sýkýþtýrma
ICP - Arayüz Deðiþikliði Teklifi
Kimlik - Kimlik
IDB - Entegre Veritabaný
IER - Bilgi Deðiþimi Gereksinimi
IFF - Kimlik bilgisi - Arkadaþ veya Düþman
IFR - Araç Uçuþ Kurallarý
IIF - Görüntü Deðiþim Biçimi
IJMS - Geçici Ortak Taktik Bilgi Daðýtým Sistemi
  (JTIDS) Mesaj Þartname
IM - Duyarsýz Mühimmat
INS - Ataletsel Navigasyon Sistemi
IOP - Arayüz Çalýþma Prosedürleri
IP - Ýnternet Protokolü
IR - Kýzýlötesi
IREP - Resim Gösterimi
ISO - Uluslararasý Standartlar Organizasyonu
BT - Bilgi Teknolojisi
JCS - Genelkurmay Baþkaný
JCSE - Ortak Ýletiþim Elemanlarý Elemaný
JDAM - Ortak Doðrudan Saldýrý Mühimmatý
JINTACCS - Taktik Komuta ve Kontrol Ortak Birlikte Çalýþabilirliði
  Sistemler
JITC - Ortak Birlikte Çalýþabilirlik Testi Komutanlýðý
JMTOP - Ortak Çok Taktik Veri Baðlantýsý (TDL) Çalýþma Prosedürleri
JOPES - Ortak Operasyon Planlama ve Yürütme Sistemi
JPEG - Birleþik Fotoðraf Uzmanlarý Grubu


JPF - Ortak Programlanabilir Tapa
JROCM - Ortak Gereklilikler Gözetim Konseyi Memorandumu
JSOW - Ortak Stand-Off Silahý
JTAC - Ortak Terminal Saldýrý Denetleyicisi
JTB - Ortak Ulaþým Kurulu
JTIDS - Ortak Taktik Bilgi Daðýtým Sistemi
JU - JTIDS BÝRÝMÝ
JVIDS - Ortak Görsel Entegre Görüntüleme Sistemi
KG - Kilogram
KIA - Aksiyonda Öldürüldü
KILO - Kilometre
KPH - Saat Baþýna Kilometre
LAAD - Düþük Ýrtifa Hava Savunma
LAN - Yerel Alan Aðý
LAT / LONG - Enlem / Boylam
LCH CAP - Baþlatma Özelliði
LND ACT - Kara Platformu Etkinliði
LND PLT - Kara Platformu
LOCG - Konum Izgarasý
LRP - Referans Noktasýný Baþlat
LSB - En Az Önemli Bit
LWR - Lazer Uyarý Alýcýsý
MA - Makine Onay
MACS - Modüler Topçu Þarj Sistemi
MAPAM - Harç Karþýtý Personel Karþýtý Malzeme
MEDEVAC - Týbbi Tahliye
MEHTF - Çok Olaylý Sert Hedef Fuzesi
MFF - Çok Ýþlevli Parçalanma
MGB - Ana Diþli Kutusu
MIA - Eylemde Eksik
MIIDS - Askeri Ýstihbarat Entegre Veri Sistemi
MIL - Askeri
MIJI - Meaconing, Ýzinsiz Giriþ, Sýkýþma ve Giriþim
MIL-STD - Askeri Standart
MIN IMP - Minimum Uygulama
MLRS - Çoklu Roket Roket Sistemi
MOOTW - Savaþ Dýþý Askeri Operasyonlar
MOPP - Görev Odaklý Koruyucu Duruþ
MOS - Askeri Mesleki Uzmanlýk
MPSM - Çok Amaçlý Submunition
MSB - En Önemli Bit
MSD - Minimum Güvenli Mesafe
MSG - Mesaj
MSG - Çok Kaynaklý Grup


MSL - Ortalama Deniz Seviyesi
MTI - Hareketli Hedef Göstergesi
MTO - Gözlemciye Mesaj
MTS - Deniz Taktik Sistemleri
MTST - Hedef Ýstatistiki Ýzleme Manevrasý
M4 IND - Mod IV Göstergesi
NATO - Kuzey Atlantik Antlaþmasý Örgütü
NBC - Nükleer, Biyolojik, Kimyasal
NCA - Ulusal Komuta Otoriteleri
NCS - Að Kontrol Ýstasyonu
Nd: YAG - Neodimyum Yttrium Alüminyum Garnet
NGA - Ulusal Mekansal Zeka Ajansý
NGF - Deniz Silah Ateþi
NICOM - Resim Yorum Sayýsý
NITF - Ulusal Görüntü Ýletim Biçimi
NITFS - Ulusal Görüntü Ýletim Biçimi Standardý
NLOS-M - Görüþ Hattý Olmayan - Harç
NMS - Að Ýzleme Ýstasyonu
NORAD / USELMNORAD - Kuzey Amerika Havacýlýk ve Uzay Savunma Komutanlýðý / ABD Elementi, Kuzey
  Amerikan Havacýlýk ve Uzay Savunma Komutanlýðý
NPG - Network Katýlým Grubu / Needline Katýlým Grubu
NSA - Ulusal Güvenlik Ajansý
NSFS - Deniz Yüzeyi Ateþ Desteði
NSIF - NATO Ýkincil Görüntü Formatý
NTB - NITF Teknik Kurulu
NTP - Termal Olmayan Korumalý
OA - Operatör Onayý
OAT - Operasyonel Hava Trafiði
ODCSOPS - Operasyon Genel Sekreter Yardýmcýsý Ofisi
OPFAC - Operasyonel Tesis
OPLAN - Operasyon Planý
OPO - Optik Parametrik Osilatörler
OPORD - Ýþlem Emri
OSI - Açýk Sistemler Baðlantýsý
PADS - Konum Belirleme Sistemi
PCS - Kiþisel Ýletiþim Sistemi
PFF - Önceden Oluþturulmuþ Fragmanlar
PFN - Darbe Oluþturan Að
PGB - Hassas Kýlavuzlu Bomba
PGMM - Hassas Kýlavuzlu Harç Mühimmatý
PIM - Yük Arayüzü Modülü
PIR - Pasif Kýzýlötesi
PLL - Öngörülen Yük Listesi
PLR - Polarizasyon


PLV - Takým Liderliði Aracý
POL - Petrol, Yaðlar, Yaðlayýcýlar
YEDEKLER - Savaþ Tutsaklarý
PRF - Darbe Tekrarlama Frekansý
PRI - Darbe Tekrarlama Aralýðý
R / C - Makbuz / Uygunluk
REDCON - Hazýrlýk Durumu
REGEX - Normal Ýfade
RES - Rezerve Eklenti Bölümleri
RF - Radyo Frekansý
ROTA - Saldýrýdan Baþka Serbest Býrakma
RS - Radyo Takýmý
RTM - Tüfek Çekmeli Harç
RWR - Radar Uyarý Alýcýsý
S / A - Servis / Ajans
SA - Durumsal Farkýndalýk
SADARM - Zýrh Ara ve Yok Et
SAL - Yarý Aktif Lazer
SCC - Seri Ýletiþim Kanalý
SCP - Anket Kontrol Noktasý
S / C SW - Kare / Daire Anahtarý
SDB - Küçük Çaplý Bomba
SDL - Sensör Veri Baðlantýsý
SFW - Sensör Fuzed Silahý
SIF - Seçici Kimlik Özelliði
SINCGARS - Tek Kanallý Zemin ve Hava Telsiz Sistemi
SIP - SINCGARS Geliþtirme Programý
SNDL - Standart Deniz Kuvvetleri Daðýtým Listesi
SORTS - Kaynaklarýn Durumu ve Eðitim Sistemi
SPC PLT - Uzay Platformu
SPU - Ýkincil Güç Ünitesi
SRI - Bilgi Daimi Talebi
SRW - Asker Radyo Dalgasý
SSA - Yüzeye Yüzey Topçu
SSM - Yüzeye Yüzeye Füze
STANAG - NATO Standardizasyon Anlaþmasý
STAR - Ýstasyon Dizisi
STN - Kaynak Parça Numarasý
STR - Güç
SUB ACT - Yeraltý Platformu Etkinliði
SUB PLT - Yeraltý Platformu
SUR ACT - Yüzey Platformu Etkinliði
SUR PLT - Yüzey Platformu
SV - Uydu Araçlarý


SVC - Anahtarlamalý Sanal Devre
T / O - Organizasyon Þemasý
TACAN - Taktik Hava Navigasyon
TACMS - Taktik Füze Sistemi
TACP - Taktik Hava Kontrol Partisi
TACTS - Taktik Aircrew Savaþ Eðitim Sistemi
TAR - Taktik Hava Talebi
TBD - Belirlenecek
TCA - Kule Kontrol Alaný
TDL - Taktik Veri Baðlantýsý
TDS - Taktik Veri Sistemi
TGB - Kuyruk Diþli Kutusu
THM - Termal Posta Mühimmatý
TIDP-TE - Teknik Arayüz Tasarým Planý - Test Sürümü
TIME FCT - Zaman Ýþlevi
TLAM - Tomahawk Karaya Saldýrý Füzesi
TO & E / TDA - Organizasyon ve Donaným Tablosu / Daðýtým Tablosu
  ve Ödeneði
TOR - Referans Þartlarý
TOT - Hedef Zaman
TOW - Tüplü Optik Olarak Ýzlenen Tel Güdümlü Füze
TP - Hedef Uygulamasý; Termal korumalý
TPT - Birlik Yeterliliði Eðitmeni
TPU - Hedef Konum Güncellemesi
T / R - Gönderme / Alma
TRE - Tagged Kayýt Uzantýsý
TRKD VEH - Paletli Araç
ÝHA - Ýnsansýz Hava Aracý
UCAV - Ýnsansýz Savaþ Hava Aracý
UIC - Birim Kimlik Kodu
URN - Birim Referans Numarasý
USCENTCOM - Birleþik Devletler Merkez Komutanlýðý
USEUCOM - Birleþik Devletler Avrupa Komutanlýðý
USJFCOM - Birleþik Devletler Ortak Kuvvetler Komutanlýðý
USMTF - Birleþik Devletler Mesaj Metni Formatlarý
USNO - Birleþik Devletler Deniz Gözlemevi
USNORTHCOM - Birleþik Devletler Kuzey Komutanlýðý
USPACOM - Birleþik Devletler Pasifik Komutanlýðý
USSOC - Amerika Birleþik Devletleri Özel Harekat Komutanlýðý
USSOUTHCOM - Birleþik Devletler Güney Komutanlýðý
USSTRATCOM - Birleþik Devletler Stratejik Komutanlýðý
USTRANSCOM - Birleþik Devletler Ulaþtýrma Komutanlýðý
UTC - Evrensel Zaman Koordinatý
UTR - Birim Görev Yeniden Düzenlenmesi


VFR - Görsel Uçuþ Kurallarý
VMF - Deðiþken Mesaj Formatý
VU - VMF Birimi
WAN - Geniþ Alan Aðý
WCMD - Rüzgar Düzeltilmiþ Mühimmat Daðýtýcýsý
WDU - Savaþ Baþlýðý Ünitesi
WIA - Eylemdeki Yaralýlar
WGS-84 - Dünya Jeodezik Sistemi - 84
WILCO - Uygun Olacak
WNW - Geniþ Bant Að Dalga Formu
WP - Beyaz Fosfor
WTR MDE - Savaþ Süresi Koruma Modu
XM - Deneysel Model
XML - Geniþletilebilir Ýþaretleme Dili
XML-VMF - Geniþletilebilir Ýþaretleme Dili - Deðiþken Mesaj Biçimi





